111111111111111111111111111
10P000000000000000000000001
100000000000000000000000001
100000CCCCC00000CCCCC000001
10000C00000CC0CC00000C00001
1000C00111100C00111100C0001
1000C01000011011000010C0001
1000C01000000E00000010C0001
1000C01000000000000010C0001
10000C010000000000010C00001
100000C0100000000010C000001
1000000C01100000110C0000001
10000000C001101100C00000001
100000000CC00100CC000000001
10000000000C000C00000000001
100000000000CCC000000000001
100000000000000000000000001
111111111111111111111111111