11111111111111111111111111111
100010001000100010C0100010001
1P100C100010001000100010C0101
11111111111111111111111111101
100010001C0010001000100C10001
1010C01000100010C010001000101
10111111111111111111111111111
10001000100010001000100C10001
101000100C1000100010001000101
11111111111111111111111111101
100010C0100010001000100010C01
10100010001000100C10001000101
1C111111111111111111111111111
1000100010C010001000100010001
101000100010001000100C1000101
111111111111111111111111111C1
1000100010C010001000100010001
101C0010001000100010C01000101
10111111111111111111111111111
10001C0010001000100010C010001
10100010001C001000100010C0101
11111111111111111111111111101
100C1000100010001C00100010001
1E100010C010001000100010C0101
11111111111111111111111111111