111111111111111111111111111111111
1001001000000000010000000000000E1
1P0100100000000001000C00000000001
100100100000000001000000000000001
100100100000000001000000000000001
100100111000000001000000000000001
1001001010000000010000000C0000001
101100001001111001000000000000001
10010011100100000100C000000000001
1001001000010000010000000C0000001
100100101111111111000000000000001
100000000000000000000000000000001
111111111111111111111111111111111
