111111111111111111111111111111111
10P10010000000C001000000000000001
10100010000011111100C000000000E01
10010010C000000001000000000000001
100100100000111111000000000000001
100100111000000001000000000000001
1001001010000000010000000C0000001
101100001001111001000000000000001
10010011100100C001111100000000001
1001001000010000010000000C0000001
100100101111111111000000000000001
100000000000000000000000000000001
111111111111111111111111111111111
