1111111111111111111111111111111111111111111111111
10P0100000000C00000010000000000000001000000000001
1000100011111111100010001111100011111111100011111
10001000000000000000100000C0000000001000000000001
1000100000000C00000000000000000000001000000000001
1000100000000000000010000000000000001000000000001
1000100011111111100010001111100011111111100011111
1000100000000000000010000000000000001000000000001
1000100000000000000010000000C00000000000000C00001
1000100000000000000010000000000000001000000000001
1000100011111111100010001111100011111111111111111
1000100000000000000010000000000000001000000000001
1000100000000000000010000000000000001000000000001
100010000000C000000010000000000000000000000C00001
1000100000000000000010000000000000001000000000001
1000100011111111100010001111100011111111111011111
1000100000000000000010000000000000001000000000001
1000100000000000000010000000000000001000000000001
1000100011111111100010001111100011111111100011111
10000000C00000000000100000000000000010000000000E1
1111111111111111111111111111111111111111111111111

