111111111
1P0000001
1000C0001
100000E01
111111111
