11111111111111111111
1P000000000000000001
10111111111011111101
10100000001010C00101
10101111101010110101
10101000101010100101
10101110111010110101
101000100C00100C0101
10111110111011110101
100000100C1010000001
10111011101011101101
100010C0001000001001
11101110111011101111
100010C0101010C01001
10111010101010101101
10000010100010000001
10111110111011110101
10100010000010C00101
1C101110111010110101
10101000001010100101
10101111101010110101
101000C0001010000101
10111111111011111101
10000C00000C00000E01
11111111111111111111