11111111111111111111111
10000C00C010C0001C00001
1000000000100000C000001
100C0000C01000001111111
11111111101C000000C0001
1000C000101000000000001
10000000101110111111111
10000C001000000000C0001
10C00000100P001000000E1
100000C0000000111111111
11111111101110100000C01
10000000000100000000001
100000C0000111101111111
11111101111100000000C01
10000000000111111110111
1000C000000000C00000001
11111111111111111111111